1111111111111
10N10000000C1
1000011110001
1P0011E0N0001
1111111111111